40 40 32
3 3 3 3 3 3 5 6 5 6 5 6 5 6 5 6 5 6 5 6 5 6 5 6 5 6 5 6 5 6 5 6 5 6 5 6 5 6 5 6
3 3 3 3 1 1 7 8 7 8 7 8 7 8 7 8 7 8 7 8 7 8 7 8 7 8 7 8 7 8 7 8 7 8 7 8 7 8 7 8
3 1 3 3 4 1 1 1 1 1 1 1 1 5 6 5 6 5 6 1 5 6 1 1 5 6 1 1 5 6 1 1 1 1 5 6 5 6 5 6
1 1 1 3 3 4 4 1 1 1 1 1 1 7 8 7 8 7 8 1 7 8 5 6 7 8 1 1 7 8 1 1 1 1 7 8 7 8 7 8
1 5 6 3 3 3 3 4 4 1 1 1 1 1 1 1 1 5 6 1 1 1 7 8 1 1 1 1 1 1 1 1 5 6 1 1 5 6 5 6
1 7 8 3 3 3 3 3 3 1 1 1 1 1 1 1 1 7 8 5 6 5 6 1 1 1 1 1 1 1 1 1 7 8 5 6 7 8 7 8
5 6 1 1 1 3 3 3 3 5 6 1 1 1 1 1 1 1 1 7 8 7 8 1 1 1 1 1 1 1 1 5 6 1 7 8 1 1 5 6
7 8 1 1 1 1 1 1 1 7 8 1 1 1 1 1 1 1 5 6 1 1 5 6 1 1 1 1 1 5 6 7 8 1 1 1 5 6 7 8
1 5 6 1 1 1 1 1 1 1 1 1 1 1 1 1 1 1 7 8 1 1 7 8 5 6 1 1 1 7 8 1 1 1 1 1 7 8 5 6
3 7 8 1 4 4 4 1 1 1 1 1 1 5 6 1 1 1 1 1 1 5 6 1 7 8 1 1 1 1 1 1 1 1 1 1 1 1 7 8
3 3 3 3 3 3 3 1 1 1 5 6 1 7 8 1 1 1 1 1 1 7 8 1 5 6 1 1 4 4 4 1 1 1 1 1 1 1 5 6
3 3 3 3 3 3 1 1 1 1 7 8 5 6 1 1 1 1 1 1 1 1 5 6 7 8 1 1 3 3 3 1 1 1 1 1 1 1 7 8
3 3 3 3 3 3 1 1 1 5 6 1 7 8 1 1 1 1 1 1 5 6 7 8 1 1 1 1 3 3 3 1 1 1 1 1 1 1 5 6
3 1 5 6 3 3 4 1 1 7 8 1 1 1 1 1 1 1 5 6 7 8 1 1 1 1 1 1 3 3 3 1 1 1 1 1 1 1 7 8
3 1 7 8 1 3 3 4 4 4 5 6 1 1 1 1 1 1 7 8 1 5 6 1 1 1 1 1 3 3 3 1 1 4 1 1 1 1 5 6
5 6 1 1 1 3 3 3 3 3 7 8 1 1 1 1 1 1 5 6 1 7 8 1 1 1 1 1 3 3 3 1 4 3 4 1 1 1 7 8
7 8 5 6 1 1 1 1 1 1 1 1 1 1 1 1 1 1 7 8 5 6 1 1 1 1 1 1 3 3 3 4 3 3 3 4 1 1 5 6
5 6 7 8 1 1 1 1 1 1 1 1 1 1 1 1 1 1 1 1 7 8 1 1 1 1 4 4 3 3 3 3 3 3 3 3 1 1 7 8
7 8 1 1 1 1 1 1 4 4 4 4 4 1 1 1 1 1 1 1 1 1 1 1 1 4 3 3 3 3 3 3 3 3 3 3 1 1 5 6
5 6 1 1 1 4 4 4 3 3 3 3 3 1 1 1 4 4 1 1 1 1 4 4 4 3 3 3 3 3 3 3 3 3 3 3 1 1 7 8
7 8 4 1 1 3 3 3 3 3 3 3 1 5 6 1 3 3 4 4 4 4 3 3 3 3 3 3 3 3 3 3 3 3 3 3 1 1 5 6
5 6 3 4 4 3 3 3 3 3 3 5 6 7 8 1 3 3 3 3 3 3 3 3 3 3 3 3 3 3 3 3 3 3 3 3 1 1 7 8
7 8 3 3 3 3 3 3 3 3 1 7 8 1 1 1 3 3 3 3 3 3 3 3 3 3 3 3 3 3 3 3 3 3 3 3 1 1 5 6
5 6 1 3 3 3 3 3 3 3 1 1 1 1 1 4 3 3 3 3 3 3 3 3 3 3 3 3 3 3 3 3 3 3 3 1 1 1 7 8
7 8 5 6 3 3 3 3 3 5 6 1 1 1 4 3 3 3 3 3 3 3 3 3 3 3 3 3 3 3 3 3 3 3 3 1 1 1 5 6
5 6 7 8 3 3 3 3 3 7 8 1 4 4 3 3 3 3 3 3 3 3 3 3 3 3 1 1 3 3 3 3 3 3 3 1 1 1 7 8
7 8 1 3 3 3 3 3 1 1 1 4 3 3 3 3 3 3 3 3 3 3 3 3 3 1 1 5 6 3 3 3 3 3 5 6 1 1 5 6
1 1 3 3 3 3 3 3 1 1 4 3 3 3 3 3 3 3 3 3 3 3 3 5 6 1 1 7 8 3 3 1 1 1 7 8 1 1 7 8
5 6 3 3 3 3 3 3 1 4 3 3 3 3 3 3 3 3 3 3 3 5 6 7 8 1 1 1 1 1 1 1 1 1 1 1 1 1 5 6
7 8 1 3 3 3 3 1 1 3 3 3 3 3 3 3 3 3 3 3 3 7 8 1 1 1 1 4 4 4 4 4 4 4 4 4 1 1 7 8
1 1 1 1 3 3 3 1 1 3 3 3 3 3 3 3 3 3 3 3 3 3 1 1 4 4 4 3 3 3 3 3 3 3 3 3 1 1 5 6
1 1 5 6 3 3 3 1 1 3 3 3 3 3 3 3 3 3 3 3 3 3 3 3 3 3 3 3 3 3 3 3 3 3 3 3 1 1 7 8
5 6 7 8 3 3 3 1 1 3 3 3 3 3 3 3 3 3 3 3 3 3 3 3 3 3 3 3 3 3 3 3 3 3 3 3 1 1 5 6
7 8 1 1 3 3 1 1 1 1 1 3 3 3 3 3 3 3 3 3 3 3 3 3 3 3 3 3 3 3 3 3 3 3 3 3 1 1 7 8
5 6 1 1 1 1 1 1 1 1 5 6 3 3 3 3 3 3 3 3 3 3 3 3 3 3 3 3 3 3 3 3 3 3 3 1 1 1 5 6
7 8 1 1 1 1 1 1 1 1 7 8 1 3 3 3 3 3 3 3 3 3 3 3 3 3 3 3 3 3 3 3 3 3 1 1 1 1 7 8
5 6 1 1 5 6 1 1 1 1 1 1 1 1 1 1 1 1 1 1 1 1 1 1 1 1 1 1 1 1 1 1 1 1 1 1 1 5 6 1
7 8 1 1 7 8 5 6 1 1 1 1 1 1 1 1 1 1 1 1 1 1 1 1 1 1 1 1 1 1 1 1 1 1 1 1 1 7 8 1
5 6 1 1 5 6 7 8 5 6 5 6 5 6 5 6 5 6 5 6 5 6 5 6 5 6 5 6 5 6 5 6 5 6 5 6 5 6 5 6
7 8 1 1 7 8 1 1 7 8 7 8 7 8 7 8 7 8 7 8 7 8 7 8 7 8 7 8 7 8 7 8 7 8 7 8 7 8 7 8

2 384 160 32 32 1
[
Hello World
]

3 384 416 32 32 0
